11111111111111111111111111111111
1..............................1
1..............................1
1..............................1
1...1.....1...1.11....1.11.....1
1....1...1...1....1..1....1....1
1.....1.1....1....1..1....1....1
1.................1..1....1....1
1.....1......1.......1....1....1
1....1.......1....1...1.11.....1
1..............................1
1..............................1
1.....1.......1................1
1......1.........1......1......1
1...........1.....1....1.......1
1........1.1.......1...........1
1.........1....................1
1...................1.1........1
1.............M....1...1.......1
1........M........1.....1......1
1...............M..............1
1...........M.............P....1
1..............................1
11111111111111111111111111111111
